00000000000000
00000000000000
00000000000000
00000000000000
00001111110000
00011000011000
00010202201000
00013333331000
00010220201000
00011104111000
00000111100000
00000000000000
00000000000000
00000000000000
