00000000000000
00000000000000
00001111111100
00001000130100
00011002333100
00010020153100
00110112101100
00100020020100
00100010000100
00111111140100
00000000111100
00000000000000
00000000000000
00000000000000
