00000000000000
00000000000000
00011111000000
00014001011100
00010221013100
00010201113100
00011100003100
00001100000100
00001000100100
00001000111100
00001111100000
00000000000000
00000000000000
00000000000000
