00000000000000
00000000000000
00001111000000
00001401110000
00001020010000
00011101011000
00013101001000
00013200101000
00013000201000
00011111111000
00000000000000
00000000000000
00000000000000
00000000000000
