00000000000000
00000000000000
00000000000000
00000000000000
00000000000000
00001111110000
00001020310000
00001402310000
00001111110000
00000000000000
00000000000000
00000000000000
00000000000000
00000000000000
