00000000000000
00000000000000
00000000000000
00000111000000
00000131000000
00000101111000
00011120231000
00013024111000
00011112100000
00000013100000
00000011100000
00000000000000
00000000000000
00000000000000
