00000000000000
00000000000000
00000000000000
00000111111000
00000100001000
00011122201000
00014023301000
00010233311000
00011110010000
00000011110000
00000000000000
00000000000000
00000000000000
00000000000000
