00000000000000
00000000000000
00000000000000
00000000000000
00111100111110
01100100100010
01020111120010
01002333302010
01100001040110
00111111111100
00000000000000
00000000000000
00000000000000
00000000000000
