00000000000000
00000000000000
00000000000000
00000111110000
00011100410000
00010023011000
00010032301000
00011105201000
00000100011000
00000111110000
00000000000000
00000000000000
00000000000000
00000000000000
