00000000000000
00000000000000
00000000000000
00000111100000
00000133100000
00001103110000
00001002310000
00011020011000
00010012201000
00010040001000
00011111111000
00000000000000
00000000000000
00000000000000
