00000000000000
00000000000000
00000000000000
00011111111000
00010010001000
00010233201000
00014235011000
00010233201000
00010010001000
00011111111000
00000000000000
00000000000000
00000000000000
00000000000000
