00000000000000
00000000000000
00011111100000
00010000111000
00010200001000
01110201101000
01333020001000
01333212011000
01111010201000
00001004001000
00001111111000
00000000000000
00000000000000
00000000000000
