00000000000000
00000000000000
00000000000000
00111111000000
00100001000000
00102221100000
00100133111000
00110033201000
00010400001000
00011111111000
00000000000000
00000000000000
00000000000000
00000000000000
