00000000000000
00000000000000
00011111110000
00013333010000
00111333211100
00100212020100
00102200120100
00100001000100
00111104011100
00000111110000
00000000000000
00000000000000
00000000000000
00000000000000
