00000000000000
00000000000000
00000000000000
00001111111000
00001332331000
00001331331000
00001022201000
00001002001000
00001022201000
00001001401000
00001111111000
00000000000000
00000000000000
00000000000000
