00000000000000
00000000000000
00000000000000
00011111110000
00010000011100
00112111000100
00104020020100
00103310201100
00113310001000
00011111111000
00000000000000
00000000000000
00000000000000
00000000000000
