00000000000000
00000000000000
00000111100000
00001100100000
00001420100000
00001120110000
00001102010000
00001320010000
00001335310000
00001111110000
00000000000000
00000000000000
00000000000000
00000000000000
