00000000000000
00001111111000
01111000001000
01000311101000
01010100001100
01010202130100
01010050010100
01031202010100
01100001010111
00101113000041
00100000110001
00111111111111
00000000000000
00000000000000
