00000000000000
00000000000000
00000000000000
00000000000000
00001111111000
00011001041000
00010001001000
00012020201000
00010211001000
01110201011000
01333330010000
01111111110000
00000000000000
00000000000000
