00000000000000
00000000000000
00000111111000
00011100001000
00113021101100
00133202004100
00133020201100
00111111001000
00000001111000
00000000000000
00000000000000
00000000000000
00000000000000
00000000000000
