00000000000000
00000000000000
00011111111100
00010011000100
00010002000100
00012011102100
00010133310100
00110133310110
00102002002010
00100000104010
00111111111110
00000000000000
00000000000000
00000000000000
